WWWWWWWWWWWWWWWWWWWWWWWWWWWWWWWWW
WWWWWWWWWWWWWWWWWWWWWWWWWWWWWWWWW
WOOOWWWWWWWWWWWWWWWWWWSSSSSWWWWWW
WWOOWGTTTTGFFWWSSSWWWWSSSSSWWWWWW
WWWWGGTTTTFFFFAGGGIIIWWWWWGGGGWWW
WWWGGOTTMCMMGFAGGGIIIGWWSGLLGGGWW
WWGOOOOMCCMIIGGGGTTTTGGSSGLLGGGWW
WWGGGGGAMMIIIGGGTTTTTTGGGGLGGGGWW
WWGGGGGALLLIGGFFTTTTTTFFFFFGTGGWW
WWWGGGGGMMMFFFFFFFFTFFFFFFFTTGWWW
WWGGGTTTTGFFFFFFFFFFFFFFFFGTTGWWW
WWGGGTTTTFFFFFFFFFFFFFFCCLMTTGWWW
WWGGGTTTGGFFFFTTTTTFGGMMCLMGTTGWW
WWGGGGGGLGGGGTTTTTTTGMILLIMGTTGWW
WWGGGGGGMLMGOOOWWWTTGGIMMMFFTTGWW
WWWWSSWIMAMWWOOWSSWWGGGFWFFFTGGWW
WWWWSSWIMAWWWWWWSSWOOWFFFWFFFGWWW
WWWWSWGIMMSSSWWWWWWWWWWFFFWFWSSWW
WWWWWWWWWWWWWWWWWWWWWWWWWWWWWWWWW
