WWWWWWWWWWWWWWWWWWWWWWWWWWWWWWWW
WOOOWWWWWWWWWWWWWWWWWWSSSSSWWWWW
WWOOWGTTTTGFFWWSSSWWWWSSSSSWWWWW
WWWWGGTTTTFFFFAGGGIIIWWWWWGGGGWW
WWWGGOTTMCMMGFAGGGIIIGWWSGLLGGGW
WWGOOOOMCCMIIGGGGTTTTGGSSGLLGGGW
WWGGGGGAMMIIIGGGTTTTTTGGGGLGGGGW
WWGGGGGALLLIGGFFTTTTTTFFFFFGTGGW
WWWGGGGGMMMFFFFFFFFTFFFFFFFTTGWW
WWGGGTTTTGFFFFFFFFFFFFFFFFGTTGWW
WWGGGTTTTFFFFFFFFFFFFFFCCLMTTGWW
WWGGGTTTGGFFFFTTTTTFGGMMCLMGTTGW
WWGGGGGGLGGGGTTTTTTTGMILLIMGTTGW
WWGGGGGGMLMGOOOWWWTTGGIMMMFFTTGW
WWWWSSWIMAMWWOOWSSWWGGGFWFFFTGGW
WWWWSSWIMAWWWWWWSSWOOWFFFWFFFGWW
WWWWSWGIMMSSSWWWWWWWWWWFFFWFWSSW
WWWWWWWWWWWWWWWWWWWWWWWWWWWWWWWW
